  0   147   149   173   105   173   117   141   175   128   169     4     7     3   128     5   130   131   147     2   172   173     5   136    10   142   132
147     0     7   114    11   115    17     3    89    31   110   117   145   150    42   149    43    43     0   149   112   114   138    34    92     4    38
149     7     0   106    16   107    20    11    84    32   103   119   147   152    41   151    43    44     7   151   103   106   140    34    95    12    39
173   114   106     0    90     5    81   114    85    75     3   152   172   176    58   175    71    73   114   175     1     9   165    71   131   114    78
105    11    16    90     0    91     6     9    61    24    86    79   103   108    31   107    33    34    11   106    87    89    97    18    58    10    31
173   115   107     5    91     0    82   115    89    75     2   151   172   176    59   175    71    73   115   175     9    17   165    74   131   114    78
117    17    20    81     6    82     0    16    41    25    78    91   116   121    30   119    33    34    17   119    78    80   109     8    69    17    31
141     3    11   114     9   115    16     0    91    31   110   112   139   144    43   143    43    44     2   143   112   114   132    34    88     2    38
175    89    84    85    61    89    41    91     0    73    85   150   173   178    70   177    77    78    89   177    82    83   167    20   127    92    79
128    31    32    75    24    75    25    31    73     0    70   103   127   132     4   131     4     4    30   130    73    75   120    33    81    30     5
169   110   103     3    86     2    78   110    85    70     0   147   168   172    54   171    66    68   110   171     7    14   161    70   127   110    73
  4   117   119   152    79   151    91   112   150   103   147     0     6     4   104     5   105   106   117     3   150   152     7   110     3   113   107
  7   145   147   172   103   172   116   139   173   127   168     6     0     8   127     4   128   129   145     6   171   172    11   134    11   140   130
  3   150   152   176   108   176   121   144   178   132   172     4     8     0   132     5   133   134   150     1   175   177     8   139    11   145   135
128    42    41    58    31    59    30    43    70     4    54   104   127   132     0   131     2     3    42   130    57    60   120    35    83    42     5
  5   149   151   175   107   175   119   143   177   131   171     5     4     5   131     0   132   133   149     4   174   176    10   138    11   144   134
130    43    43    71    33    71    33    43    77     4    66   105   128   133     2   132     0     2    43   132    69    71   121    40    84    42     5
131    43    44    73    34    73    34    44    78     4    68   106   129   134     3   133     2     0    43   133    71    73   123    41    85    42     5
147     0     7   114    11   115    17     2    89    30   110   117   145   150    42   149    43    43     0   149   112   114   138    34    92     4    38
  2   149   151   175   106   175   119   143   177   130   171     3     6     1   130     4   132   133   149     0   174   176     7   138    10   144   134
172   112   103     1    87     9    78   112    82    73     7   150   171   175    57   174    69    71   112   174     0     7   164    69   130   111    77
173   114   106     9    89    17    80   114    83    75    14   152   172   177    60   176    71    73   114   176     7     0   166    70   132   114    78
  5   138   140   165    97   165   109   132   167   120   161     7    11     8   120    10   121   123   138     7   164   166     0   127    10   133   124
136    34    34    71    18    74     8    34    20    33    70   110   134   139    35   138    40    41    34   138    69    70   127     0    86    35    39
 10    92    95   131    58   131    69    88   127    81   127     3    11    11    83    11    84    85    92    10   130   132    10    86     0    88    85
142     4    12   114    10   114    17     2    92    30   110   113   140   145    42   144    42    42     4   144   111   114   133    35    88     0    37
132    38    39    78    31    78    31    38    79     5    73   107   130   135     5   134     5     5    38   134    77    78   124    39    85    37     0

